#################################...........#
#####.......#####################...........#
###............####.........#######.........#
##..............#..............###........###
#..............................##.........###
#..............................####........##
##.............................####........##
........######....#.............###........##
.......#########.#####..........####......###
......####.....######....#......#####...#####
............C................................
#####..........x..........###################