##################################....##.....
######.......#####################...........
####............####.........#######.........
###..............#..............###......####
##..............................##.....######
##..............................####......###
###.............................####........#
.........######....#.............###........#
........#########s#####..........####......##
.......####.....######....#......#####...####
.............C.................c.............
######..........x..........##################