###..............#####....C..................
###...##........######....................###
###............########..###.......##########
###..............##############.########.....
####........................######....#......
####.........................................
####...####..........s.......................
####....##.........###.......................
#####.........s.....###......................
#####.......####............#................
######.......##............###...............
########.....................................