############################################.
###########################################..
.............................................
.............................................
.............................................
.............................................
.............................................
.............................................
.............................................
.............................................
.......................................c.....
#############################################