#............................................
#..................#.........................
#.................##.........................
#................###.........................
#................###.........................
#..............C.####........................
#................####........................
#................####........................
#.............#######........................
##.............######........................
##......###......#####.......................
###......#.......#####.......................