.############################################
...##########################################
....###########..............................
##############...............................
.##.#######..................................
....######...................................
.#..#####....................................
########.....................................
##..####.....................................
....###......................................
....##.......................................
#############################################