.............................................
...................#.........................
..................##.........................
.................###.........................
.................###.........................
...............C.####........................
.................####........................
.................####........................
..............#######........................
ss.............######........................
##......###......#####.......................
###......#.......#####.......................