###.......................................###
###.......................................###
###.......................................###
####.......................................##
####.......................................##
####........................................#
#####........................................
#####........................................
######.......................................
#######..........c...........................
########.......####..........................
#######################......P...............