#............................................
#............................................
#............................................
#............................................
.............................................
#............................................
##...........................................
####....................###..................
#####................########................
#######.........################.............
#############################################
#############################################