##...........................................
##...........................................
##...........................................
##...........................................
#............................................
##...........................................
###..........................................
###.......bbbb...........###.................
#....#................########...............
..######.........################............
.############################################
#############################################