...###...........x...........................
#############################################
#######.......#######.....V.......######.....
.####...........###.................##.......
####.........................................
.##..........................................
..#.................##############...........
..................##########.##.####.........
.................####...##....#..####........
...............###.##...##.........##........
...c.........###.#####...#...###..#####......
.#####...######....######################....