............................................#
............................................#
...........................................##
..........................................###
..........................................###
..........................................###
.........................................####
.........................................####
........................................#####
.......................................######
.....................................########
#####..x...........................##########