##...........................................
##...........................................
##...........................................
##...........................................
#............................................
##...........................................
###..........................................
#####....................###.................
######................########...............
########.........################............
.############################################
#############################################