.............................................
.............................................
............................................#
...........................................##
...........................................##
...........................................##
..........................................###
..........................................###
.........................................####
............................#####.......#####
.............................###.....c.######
.#####..x...........................#########