##...........................................
##...........................................
##.......####.##.............................
##........######.............................
#..........####..............................
##..........##...............................
###..........................................
###.......#####..........###.................
######.....##.........########...............
..######....#....################............
.############################################
#############################################