#############################################
#############################################
#############################################
....#####............V.....V.....V###########
.....####.............................#######
.......................#.................####
............##........##.......#...........##
............###......######....###...........
.............................................
................####.........................
............##########.......................
##.....#################..###########....####