##.......................................####
##.......................................####
##.......................................####
###.......................................###
###.......................................###
###........................................##
####........................................#
####........................................#
#####.......................................#
######......................................#
######.......####...........................#
######################......P...............#