####........###########......#####.####......
###....##...........#############........####
##...####..............########...........#..
##.....................#######......####.....
###.....................#####.........#......
##...#..................#########............
##..###.................#######.....#####....
##.........##...........#####........###....#
#.........###...........####..........#......
#...............###......##..............###.
.................................s...........
#############################################