##########......c.......................#####
#############################################
...........................##################
...................................##########
....................................#########
.....................................########
......................................#######
........................................#####
.........................................####
..........................................###
..........................................###
...........................................##