##..........................................#
##..........................................#
##..........................................#
###.........................................#
###.........................................#
###.........................................#
####........................................#
####........................................#
#####.......................................#
######......................................#
######......................................#
#######.....................P...............#
