####################
#..................#
#..C..........B....#
#..................#
#######............#
P..................#
####################
