####################
#..................#
#..C...............#
#..................#
#######............#
P..................#
####################
