#################################...........#
#####.......###########.....#####...........#
###............####...........###...........#
##..............#..............##...........#
##.............................##...........#
##.............................##...........#
##.............................##...........#
........######....#.............##.........##
.......#########.#####..........####......###
......####....C######....#......####.....####
.###..........x..........##..................
#############################################
