#################################...........#
#...............................#...........#
#...............................#...........#
#...............................#...........#
#...............................#...........#
#...............................#...........#
#...............................#...........#
#...............................#...........#
#...............................#...........#
#...............................####.....####
#............................................
#############################################
