#################################...........#
#################################...........#
#################################...........#
#####.......###########.....#####...........#
###............####...........###...........#
##..............#..............##...........#
##.............................##...........#
#...............................##.........##
#...............................####......###
#...............................####.....####
#............................................
#############################################
